way  :  ['ways', 'ways']
party  :  ['party', 'parties']
start  :  ['starts', 'start', 'starts']
product  :  ['products', 'product', 'products']
train  :  ['trains', 'train', 'trains']
indian  :  ['indian', 'indians']
lot  :  ['lot', 'lots', 'lots']
drive  :  ['drive', 'drives']
shot  :  ['shot', 'shots', 'shots']
color  :  ['colors', 'colors']
eye  :  ['eyes', 'eye', 'eyes']
credit  :  ['credit', 'credits']
meeting  :  ['meeting', 'meetings']
sunset  :  ['sunset', 'sunsets']
offer  :  ['offer', 'offers', 'offers']
stop  :  ['stop', 'stops']
chance  :  ['chance', 'chances']
child  :  ['children', 'children']
minute  :  ['minutes', 'minute', 'minutes']
team  :  ['team', 'teams']
door  :  ['door', 'doors']
topic  :  ['topic', 'topics']
blog  :  ['blogs', 'blog', 'blogs']
suite  :  ['suites']
star  :  ['star', 'stars', 'stars']
gem  :  ['gems', 'gem']
rich  :  ['rich', 'riches']
wear  :  ['wear', 'wears']
bag  :  ['bags', 'bag', 'bags']
support  :  ['support', 'supports']
holiday  :  ['holidays', 'holiday', 'holidays']
add  :  ['add', 'adds']
season  :  ['season', 'seasons', 'seasons']
couple  :  ['couples', 'couple', 'couples']
station  :  ['station', 'stations']
break  :  ['break', 'breaks', 'breaks']
family  :  ['families', 'family', 'families']
hope  :  ['hope', 'hopes']
bar  :  ['bar', 'bars', 'bars']
check  :  ['check', 'checks']
trip  :  ['trips', 'trip', 'trips']
land  :  ['land', 'lands']
trick  :  ['tricks', 'tricks']
saving  :  ['savings', 'saving', 'savings']
arrival  :  ['arrivals', 'arrival']
destination  :  ['destination', 'destinations']
street  :  ['street', 'streets', 'streets']
job  :  ['job', 'jobs', 'jobs']
ship  :  ['ship', 'ships']
secret  :  ['secrets', 'secret', 'secrets']
picture  :  ['picture', 'pictures', 'pictures']
future  :  ['future', 'futures']
line  :  ['line', 'lines', 'lines']
community  :  ['community', 'communities']
apartment  :  ['apartment', 'apartments']
share  :  ['share', 'shares', 'shares']
tour  :  ['tours', 'tour', 'tours']
archive  :  ['archive', 'archives', 'archives']
sand  :  ['sand', 'sands']
king  :  ['kings', 'king', 'kings']
time  :  ['time', 'times', 'times']
france  :  ['france', 'frances']
site  :  ['site', 'sites', 'sites']
airline  :  ['airlines', 'airline', 'airlines']
garden  :  ['gardens', 'garden', 'gardens']
bit  :  ['bit', 'bits']
window  :  ['window', 'windows']
host  :  ['hosts']
mountain  :  ['mountain', 'mountains', 'mountains']
pick  :  ['pick', 'picks']
shop  :  ['shop', 'shops']
waterfall  :  ['waterfalls', 'waterfall']
spring  :  ['springs', 'spring', 'springs']
episode  :  ['episode', 'episodes']
pay  :  ['pay', 'pays']
sign  :  ['sign', 'signs', 'signs']
foot  :  ['feet', 'feet']
field  :  ['fields', 'fields']
market  :  ['markets', 'market', 'markets']
foreigner  :  ['foreigners']
key  :  ['key', 'keys']
stone  :  ['stone', 'stones']
soul  :  ['soul', 'souls']
beach  :  ['beaches', 'beach']
lover  :  ['lovers', 'lovers']
million  :  ['million', 'millions']
attack  :  ['attack', 'attacks']
down  :  ['down', 'downs']
business  :  ['business', 'businesses']
town  :  ['towns', 'town', 'towns']
reader  :  ['readers', 'readers']
right  :  ['right', 'rights']
life  :  ['life', 'lives']
barn  :  ['barn', 'barns']
mile  :  ['miles', 'mile', 'miles']
house  :  ['house', 'houses', 'houses']
travel  :  ['travels', 'travel']
guy  :  ['guy', 'guys', 'guys']
interview  :  ['interview', 'interviews']
thing  :  ['thing', 'things', 'things']
question  :  ['question', 'questions', 'questions']
lake  :  ['lake', 'lakes']
ocean  :  ['ocean', 'oceans']
map  :  ['map', 'maps']
saturday  :  ['saturday', 'saturdays']
delay  :  ['delay', 'delays']
city  :  ['cities', 'city', 'cities']
make  :  ['makes', 'make', 'makes']
idea  :  ['idea', 'ideas', 'ideas']
writing  :  ['writing', 'writings']
backpacker  :  ['backpacker', 'backpackers']
thursday  :  ['thursday', 'thursdays']
flight  :  ['flight', 'flights', 'flights']
deal  :  ['deal', 'deals', 'deals']
wait  :  ['wait', 'waits']
magazine  :  ['magazine', 'magazines']
update  :  ['updates', 'update', 'updates']
place  :  ['places', 'place', 'places']
journey  :  ['journey', 'journeys']
impression  :  ['impressions']
expert  :  ['experts', 'experts']
view  :  ['view', 'views', 'views']
spot  :  ['spots', 'spot', 'spots']
memory  :  ['memories', 'memory', 'memories']
point  :  ['point', 'points']
boat  :  ['boat', 'boats']
fall  :  ['falls', 'fall', 'falls']
letter  :  ['letter', 'letters']
hill  :  ['hills', 'hill', 'hills']
sleep  :  ['sleep', 'sleeps']
camp  :  ['camp', 'camps']
cruise  :  ['cruise', 'cruises']
today  :  ['today', 'todays']
water  :  ['water', 'waters']
event  :  ['events', 'event', 'events']
woman  :  ['woman', 'women', 'women']
game  :  ['game', 'games']
guest  :  ['guest', 'guests']
storm  :  ['storm', 'storms']
turtle  :  ['turtles']
shoe  :  ['shoes', 'shoes']
moment  :  ['moments', 'moment', 'moments']
step  :  ['steps', 'step', 'steps']
take  :  ['takes', 'takes']
reserve  :  ['reserve', 'reserves']
space  :  ['space', 'spaces']
play  :  ['play', 'plays']
theme  :  ['theme', 'themes']
coach  :  ['coach', 'coaches']
club  :  ['club', 'clubs']
school  :  ['school', 'schools']
price  :  ['prices', 'price', 'prices']
departure  :  ['departures', 'departure']
america  :  ['america', 'americas']
style  :  ['style', 'styles']
item  :  ['items', 'items']
airport  :  ['airports', 'airport']
plan  :  ['plan', 'plans', 'plans']
walk  :  ['walk', 'walks']
friend  :  ['friend', 'friends', 'friends']
monday  :  ['monday', 'mondays']
american  :  ['americans', 'american', 'americans']
pearl  :  ['pearl', 'pearls']
treat  :  ['treat', 'treats']
guide  :  ['guide', 'guides']
post  :  ['post', 'posts', 'posts']
reason  :  ['reasons', 'reason', 'reasons']
save  :  ['save', 'saves']
vega  :  ['vegas', 'vegas']
fear  :  ['fear', 'fears']
teach  :  ['teach', 'teaches']
finding  :  ['finding', 'findings']
postcard  :  ['postcard', 'postcards']
feature  :  ['feature', 'features']
death  :  ['death', 'deaths']
building  :  ['building', 'buildings']
tourist  :  ['tourist', 'tourists', 'tourists']
put  :  ['put', 'puts']
wave  :  ['waves', 'waves']
visitor  :  ['visitors', 'visitors']
date  :  ['date', 'dates']
kilometer  :  ['kilometers', 'kilometer']
medium  :  ['media', 'media']
black  :  ['black', 'blacks']
pro  :  ['pros', 'pro']
visit  :  ['visit', 'visits']
island  :  ['islands', 'island', 'islands']
rule  :  ['rules', 'rules']
good  :  ['good', 'goods', 'goods']
local  :  ['local', 'locals']
sale  :  ['sale', 'sales']
industry  :  ['industry', 'industries']
quote  :  ['quotes', 'quotes']
image  :  ['images', 'images']
wine  :  ['wine', 'wines']
heaven  :  ['heaven', 'heavens']
kind  :  ['kind', 'kinds']
website  :  ['websites', 'website', 'websites']
win  :  ['win', 'wins']
morning  :  ['morning', 'mornings']
year  :  ['years', 'year', 'years']
restaurant  :  ['restaurants', 'restaurant', 'restaurants']
plane  :  ['plane', 'planes']
turn  :  ['turns', 'turn', 'turns']
gate  :  ['gate', 'gate', 'gates']
road  :  ['road', 'roads']
day  :  ['days', 'day', 'days']
adventure  :  ['adventures', 'adventure']
fire  :  ['fire', 'fires']
option  :  ['options', 'options']
vacation  :  ['vacations', 'vacation']
location  :  ['locations', 'location']
home  :  ['home', 'homes']
rock  :  ['rock', 'rocks', 'rocks']
show  :  ['shows', 'show', 'shows']
sport  :  ['sports', 'sports']
weekend  :  ['weekend', 'weekends']
hike  :  ['hike', 'hikes']
route  :  ['route', 'routes']
hate  :  ['hate', 'hates']
tuesday  :  ['tuesday', 'tuesdays']
number  :  ['number', 'numbers']
student  :  ['students', 'student', 'students']
week  :  ['week', 'weeks', 'weeks']
church  :  ['church', 'churches']
gift  :  ['gifts', 'gift', 'gifts']
photographer  :  ['photographers']
parent  :  ['parents', 'parents']
find  :  ['find', 'finds']
people  :  ['people', 'peoples']
friday  :  ['friday', 'fridays']
cloud  :  ['clouds', 'clouds']
pic  :  ['pic', 'pics', 'pics']
hack  :  ['hacks']
saint  :  ['saint', 'saints']
give  :  ['give', 'gives']
tree  :  ['tree', 'trees', 'trees']
comment  :  ['comment', 'comments']
war  :  ['war', 'wars']
return  :  ['return', 'returns']
recommendation  :  ['recommendations', 'recommendations']
power  :  ['power', 'powers']
move  :  ['move', 'moves']
shower  :  ['shower', 'showers']
ticket  :  ['ticket', 'tickets', 'tickets']
meet  :  ['meet', 'meets']
sky  :  ['sky', 'skies']
park  :  ['parks', 'park', 'parks']
beer  :  ['beer', 'beers']
traveler  :  ['travelers', 'traveler', 'travelers']
article  :  ['article', 'articles']
cost  :  ['costs', 'cost', 'costs']
hotel  :  ['hotels', 'hotel', 'hotels']
art  :  ['art', 'arts']
culture  :  ['culture', 'cultures']
face  :  ['faces', 'faces']
dance  :  ['dance', 'dances']
festival  :  ['festivals', 'festival']
world  :  ['world', 'worlds']
part  :  ['part', 'parts']
blue  :  ['blue', 'blues']
white  :  ['white', 'whites']
thought  :  ['thoughts', 'thought', 'thoughts']
jewel  :  ['jewel', 'jewels']
food  :  ['foods', 'food', 'foods']
bus  :  ['bus', 'buss', 'buses']
service  :  ['service', 'services']
watch  :  ['watch', 'watches']
phone  :  ['phone', 'phones']
landscape  :  ['landscapes']
story  :  ['story', 'stories', 'stories']
taste  :  ['taste', 'tastes']
wedding  :  ['wedding', 'weddings']
blogger  :  ['blogger', 'bloggers', 'bloggers']
center  :  ['center', 'centers']
jet  :  ['jet', 'jets']
photo  :  ['photos', 'photo', 'photos']
kid  :  ['kids', 'kids']
resort  :  ['resorts', 'resort']
state  :  ['state', 'states', 'states']
duty  :  ['duty', 'duties']
open  :  ['open', 'opens']
philippine  :  ['philippines']
cube  :  ['cubes']
feel  :  ['feel', 'feels']
award  :  ['award', 'awards']
trend  :  ['trends', 'trends']
month  :  ['month', 'months', 'months']
call  :  ['call', 'calls']
vote  :  ['vote', 'votes']
bed  :  ['bed', 'beds']
back  :  ['back', 'backs']
heart  :  ['heart', 'hearts']
seat  :  ['seat', 'seats']
farm  :  ['farm', 'farms']
country  :  ['countries', 'country', 'countries']
beat  :  ['beat', 'beats']
glass  :  ['glass', 'glasses']
side  :  ['side', 'sides']
fact  :  ['facts', 'facts']
female  :  ['female', 'females']
track  :  ['track', 'tracks']
bank  :  ['bank', 'banks']
essential  :  ['essential', 'essentials']
animal  :  ['animals', 'animals']
word  :  ['words', 'words']
castle  :  ['castles', 'castle']
diary  :  ['diaries', 'diary', 'diaries']
essay  :  ['essay', 'essays']
tale  :  ['tale', 'tales', 'tales']
order  :  ['order', 'orders']
car  :  ['cars', 'car', 'cars']
detail  :  ['details', 'details']
kansa  :  ['kansas', 'kansas']
photograph  :  ['photograph', 'photographs']
activity  :  ['activities', 'activities']
run  :  ['run', 'runs']
gear  :  ['gear', 'gears']
ruin  :  ['ruins', 'ruins']
queen  :  ['queen', 'queens']
rain  :  ['rain', 'rains']
rate  :  ['rates', 'rates']
baby  :  ['baby', 'babies']
term  :  ['term', 'terms']
security  :  ['security', 'securities']
custom  :  ['customs', 'customs']
alternative  :  ['alternative', 'alternatives']
hostel  :  ['hostels', 'hostel']
girl  :  ['girl', 'girls']
short  :  ['short', 'shorts']
light  :  ['lights', 'light', 'lights']
dream  :  ['dream', 'dreams', 'dreams']
region  :  ['region', 'regions']
card  :  ['card', 'cards']
agent  :  ['agent', 'agents']
miss  :  ['miss', 'misses']
film  :  ['film', 'films']
choice  :  ['choice', 'choices']
book  :  ['books', 'book', 'books']
challenge  :  ['challenge', 'challenges']
scene  :  ['scene', 'scenes', 'scenes']
mine  :  ['mine', 'mines']
lesson  :  ['lessons', 'lessons']
mean  :  ['means', 'means']
district  :  ['district', 'districts']
night  :  ['night', 'nights', 'nights']
change  :  ['change', 'changes']
wall  :  ['wall', 'walls']
fee  :  ['fee', 'fees']
camera  :  ['camera', 'cameras']
village  :  ['villages', 'village', 'villages']
experience  :  ['experience', 'experiences', 'experiences']
greek  :  ['greek', 'greeks']
hour  :  ['hour', 'hours', 'hours']
hit  :  ['hit', 'hits']
love  :  ['love', 'loves']
rise  :  ['rise', 'rises']
reservation  :  ['reservation', 'reservations']
ride  :  ['ride', 'rides']
mistake  :  ['mistakes', 'mistakes']
begin  :  ['begins', 'begins']
bird  :  ['birds', 'birds']
twitter  :  ['twitter', 'twitters']
sound  :  ['sounds', 'sound', 'sounds']
requirement  :  ['requirements', 'requirements']
cave  :  ['caves', 'cave']
getaway  :  ['getaways', 'getaway']
head  :  ['head', 'heads']
pas  :  ['pass', 'pass']
hand  :  ['hand', 'hands']
dish  :  ['dishes', 'dishes']
feeling  :  ['feeling', 'feelings']
round  :  ['round', 'rounds']
dog  :  ['dog', 'dogs']
tip  :  ['tips', 'tip', 'tips']
attraction  :  ['attractions']
room  :  ['room', 'rooms', 'rooms']
listing  :  ['listing', 'listings']
area  :  ['area', 'areas']
common  :  ['common', 'commons']
border  :  ['border', 'borders']
stay  :  ['stay', 'stays']
forest  :  ['forest', 'forests']
lao  :  ['laos']
edition  :  ['edition', 'editions']
man  :  ['man', 'mans']
tool  :  ['tool', 'tools']
technology  :  ['technology', 'technologies']
project  :  ['project', 'projects']
sunday  :  ['sunday', 'sundays']
drink  :  ['drink', 'drinks']
language  :  ['language', 'languages']
top  :  ['top', 'tops']
sea  :  ['sea', 'seas']
museum  :  ['museum', 'museums', 'museums']
list  :  ['list', 'lists']
river  :  ['river', 'rivers']
work  :  ['work', 'works']
class  :  ['class', 'classes']
review  :  ['review', 'reviews']
temple  :  ['temple', 'temples']
sight  :  ['sights', 'sights']
mind  :  ['mind', 'minds']
wonder  :  ['wonders', 'wonders']
villa  :  ['villa', 'villas']
page  :  ['page', 'pages']
case  :  ['case', 'cases']
movie  :  ['movies', 'movies']
bridge  :  ['bridge', 'bridges']
fit  :  ['fit', 'fits']
set  :  ['set', 'sets']
wednesday  :  ['wednesday', 'wednesdays']
talk  :  ['talk', 'talks']
video  :  ['video', 'videos']
group  :  ['group', 'groups']
highlight  :  ['highlights']
end  :  ['end', 'ends']
fly  :  ['fly', 'flies']
test  :  ['test', 'tests']
laugh  :  ['laughs']
rainbow  :  ['rainbows']
congratulation  :  ['congratulations']
joke  :  ['jokes']
butterfly  :  ['butterflies']
hug  :  ['hugs']
smile  :  ['smiles']
kiss  :  ['kisses']
cupcake  :  ['cupcakes']
diamond  :  ['diamonds']
angel  :  ['angels']
blessing  :  ['blessings']
winner  :  ['winners']
shine  :  ['shines']
cheer  :  ['cheers']
victory  :  ['victories']
cake  :  ['cakes']
flower  :  ['flowers']
rose  :  ['roses']
profit  :  ['profits']
opportunity  :  ['opportunities']
miracle  :  ['miracles']
grandchild  :  ['grandchildren']
fantasy  :  ['fantasies']
care  :  ['cares']
daughter  :  ['daughters']
mother  :  ['mothers']
fruit  :  ['fruits']
dollar  :  ['dollars']
valentine  :  ['valentines']
cooky  :  ['cookies']
like  :  ['likes']
championship  :  ['championships']
musician  :  ['musicians']
pet  :  ['pets']
benefit  :  ['benefits']
lady  :  ['ladies']
library  :  ['libraries']
present  :  ['presents']
prize  :  ['prizes']
wish  :  ['wishes']
hero  :  ['heroes']
firework  :  ['fireworks']
partner  :  ['partners']
computer  :  ['computers']
plant  :  ['plants']
toy  :  ['toys']
improvement  :  ['improvements']
quality  :  ['qualities']
respect  :  ['respects']
colour  :  ['colours']
fan  :  ['fans']
gentleman  :  ['gentlemen']
brother  :  ['brothers']
concert  :  ['concerts']
goal  :  ['goals']
thrill  :  ['thrills']
dad  :  ['dads']
pancake  :  ['pancakes']
song  :  ['songs']
album  :  ['albums']
prayer  :  ['prayers']
painting  :  ['paintings']
bookstore  :  ['bookstores']
comic  :  ['comics']
mom  :  ['moms']
infant  :  ['infants']
recipe  :  ['recipes']
relationship  :  ['relationships']
horse  :  ['horses']
artist  :  ['artists']
belief  :  ['believes', 'beliefs']
father  :  ['fathers']
gain  :  ['gains']
manner  :  ['manners']
novel  :  ['novels']
performer  :  ['performers']
pie  :  ['pies']
son  :  ['sons']
raindrop  :  ['raindrops']
vision  :  ['visions']
human  :  ['humans']
guitar  :  ['guitars']
desire  :  ['desires']
costume  :  ['costumes']
value  :  ['values']
antique  :  ['antiques']
buck  :  ['bucks']
dancer  :  ['dancers']
grandson  :  ['grandsons']
grant  :  ['grants']
virtue  :  ['virtues']
brain  :  ['brains']
liberty  :  ['liberties']
lyric  :  ['lyrics']
possibility  :  ['possibilities']
candle  :  ['candles']
asset  :  ['assets']
charm  :  ['charms']
firefighter  :  ['firefighters']
niece  :  ['nieces']
raise  :  ['raises']
survivor  :  ['survivors']
deposit  :  ['deposits']
solution  :  ['solutions']
spark  :  ['sparks']
theater  :  ['theaters']
tune  :  ['tunes']
volunteer  :  ['volunteers']
dress  :  ['dresses']
performance  :  ['performances']
salary  :  ['salaries']
sister  :  ['sisters']
variety  :  ['varieties']
help  :  ['helps']
ideal  :  ['ideals']
relative  :  ['relatives']
rhyme  :  ['rhymes']
singer  :  ['singers']
expression  :  ['expressions']
vocal  :  ['vocals']
tradition  :  ['traditions']
muscle  :  ['muscles']
donation  :  ['donations']
taco  :  ['tacos']
university  :  ['universities']
privilege  :  ['privileges']
cat  :  ['cats']
email  :  ['emails']
exercise  :  ['exercises']
scholar  :  ['scholars']
advantage  :  ['advantages']
ethic  :  ['ethics']
fry  :  ['fries']
lip  :  ['lips']
wing  :  ['wings']
ally  :  ['allies']
bell  :  ['bells']
chip  :  ['chips']
cousin  :  ['cousins']
illustration  :  ['illustrations']
ray  :  ['rays']
answer  :  ['answers']
paperback  :  ['paperbacks']
poem  :  ['poems']
potato  :  ['potatoes']
drum  :  ['drums']
nephew  :  ['nephews']
resource  :  ['resources']
poet  :  ['poets']
graphic  :  ['graphics']
increase  :  ['increases']
prince  :  ['princes']
si  :  ['sis']
supermarket  :  ['supermarkets']
teacher  :  ['teachers']
curve  :  ['curves']
interest  :  ['interests']
panty  :  ['panties']
hat  :  ['hats']
drawing  :  ['drawings']
generation  :  ['generations']
shore  :  ['shores']
study  :  ['studies']
twin  :  ['twins']
wage  :  ['wages']
seed  :  ['seeds']
designer  :  ['designers']
revenue  :  ['revenues']
sail  :  ['sails']
skill  :  ['skills']
think  :  ['thinks']
touch  :  ['touches']
colleague  :  ['colleagues']
ring  :  ['rings']
branch  :  ['branches']
college  :  ['colleges']
farmer  :  ['farmers']
jean  :  ['jeans']
scientist  :  ['scientists']
stream  :  ['streams']
writer  :  ['writers']
chicken  :  ['chickens']
connection  :  ['connections']
volume  :  ['volumes']
conversation  :  ['conversations']
earring  :  ['earrings']
headphone  :  ['headphones']
relation  :  ['relations']
science  :  ['sciences']
cheek  :  ['cheeks']
babe  :  ['babes']
professional  :  ['professionals']
vehicle  :  ['vehicles']
aim  :  ['aims']
regard  :  ['regards']
god  :  ['gods']
promise  :  ['promises']
u  :  ['us']
protein  :  ['proteins']
spirit  :  ['spirits']
actor  :  ['actors']
advance  :  ['advances']
athlete  :  ['athletes']
development  :  ['developments']
dvd  :  ['dvds']
produce  :  ['produces']
meaning  :  ['meanings']
author  :  ['authors']
clown  :  ['clowns']
contact  :  ['contacts']
contribution  :  ['contributions']
cowboy  :  ['cowboys']
design  :  ['designs']
foundation  :  ['foundations']
agreement  :  ['agreements']
feed  :  ['feeds']
proposal  :  ['proposals']
supporter  :  ['supporters']
yield  :  ['yields']
dynamic  :  ['dynamics']
80  :  ['80s']
advocate  :  ['advocates']
draw  :  ['draws']
emotion  :  ['emotions']
experiment  :  ['experiments']
occasion  :  ['occasions']
interaction  :  ['interactions']
band  :  ['bands']
boy  :  ['boys']
cd  :  ['cds']
eagle  :  ['eagles']
wheel  :  ['wheels']
wood  :  ['woods']
person  :  ['persons']
dividend  :  ['dividends']
launch  :  ['launches']
model  :  ['models']
principle  :  ['principles']
shirt  :  ['shirts']
strategy  :  ['strategies']
thousand  :  ['thousands']
outcome  :  ['outcomes']
chapel  :  ['chapels']
fund  :  ['funds']
know  :  ['knows']
male  :  ['males']
master  :  ['masters']
mirror  :  ['mirrors']
nurse  :  ['nurses']
sens  :  ['senses']
citizen  :  ['citizens']
customer  :  ['customers']
investment  :  ['investments']
roman  :  ['romans']
shoulder  :  ['shoulders']
telecommunication  :  ['telecommunications']
crop  :  ['crops']
audience  :  ['audiences']
boot  :  ['boots']
century  :  ['centuries']
neighborhood  :  ['neighborhoods']
suggestion  :  ['suggestions']
theory  :  ['theories']
association  :  ['associations']
shell  :  ['shells']
adult  :  ['adults']
combination  :  ['combinations']
dime  :  ['dimes']
influence  :  ['influences']
instrument  :  ['instruments']
lead  :  ['leads']
leg  :  ['legs']
outlet  :  ['outlets']
quantity  :  ['quantities']
serving  :  ['servings']
alumnus  :  ['alumni']
approach  :  ['approaches']
folk  :  ['folks']
prospect  :  ['prospects']
supply  :  ['supplies']
being  :  ['beings']
consideration  :  ['considerations']
acre  :  ['acres']
christian  :  ['christians']
concept  :  ['concepts']
egg  :  ['eggs']
engineer  :  ['engineers']
newspaper  :  ['newspapers']
objective  :  ['objectives']
program  :  ['programs']
record  :  ['records']
bean  :  ['beans']
concentration  :  ['concentrations']
metal  :  ['metals']
nation  :  ['nations']
participant  :  ['participants']
store  :  ['stores']
creature  :  ['creatures']
fingertip  :  ['fingertips']
look  :  ['looks']
message  :  ['messages']
pair  :  ['pairs']
recording  :  ['recordings']
last  :  ['lasts']
discus  :  ['discuss']
heel  :  ['heels']
hundred  :  ['hundreds']
islander  :  ['islanders']
player  :  ['players']
reach  :  ['reaches']
release  :  ['releases']
wale  :  ['wales']
deed  :  ['deeds']
export  :  ['exports']
preparation  :  ['preparations']
society  :  ['societies']
echo  :  ['echoes']
aide  :  ['aides']
boob  :  ['boobs']
chapter  :  ['chapters']
chick  :  ['chicks']
chief  :  ['chiefs']
collection  :  ['collections']
device  :  ['devices']
director  :  ['directors']
pant  :  ['pants']
pattern  :  ['patterns']
buyer  :  ['buyers']
conclusion  :  ['conclusions']
neighbor  :  ['neighbors']
rating  :  ['ratings']
reply  :  ['replies']
result  :  ['results']
score  :  ['scores']
symbol  :  ['symbols']
pocket  :  ['pockets']
application  :  ['applications']
architect  :  ['architects']
keep  :  ['keeps']
leader  :  ['leaders']
mr  :  ['mrs']
researcher  :  ['researchers']
amount  :  ['amounts']
ball  :  ['balls']
brook  :  ['brooks']
figure  :  ['figures']
nut  :  ['nuts']
observation  :  ['observations']
production  :  ['productions']
teen  :  ['teens']
variation  :  ['variations']
viewer  :  ['viewers']
attitude  :  ['attitudes']
phenomenon  :  ['phenomena']
prop  :  ['props']
circle  :  ['circles']
description  :  ['descriptions']
german  :  ['germans']
get  :  ['gets']
individual  :  ['individuals']
lay  :  ['lays']
patent  :  ['patents']
provision  :  ['provisions']
response  :  ['responses']
stage  :  ['stages']
dimension  :  ['dimensions']
example  :  ['examples']
shade  :  ['shades']
communication  :  ['communications']
philosopher  :  ['philosophers']
movement  :  ['movements']
course  :  ['courses']
network  :  ['networks']
pilot  :  ['pilots']
province  :  ['provinces']
native  :  ['natives']
action  :  ['actions']
attribute  :  ['attributes']
character  :  ['characters']
fiber  :  ['fibers']
flow  :  ['flows']
interval  :  ['intervals']
passage  :  ['passages']
plate  :  ['plates']
pop  :  ['pops']
text  :  ['texts']
worker  :  ['workers']
yes  :  ['yess']
component  :  ['components']
brand  :  ['brands']
facility  :  ['facilities']
function  :  ['functions']
maker  :  ['makers']
mechanism  :  ['mechanisms']
payment  :  ['payments']
producer  :  ['producers']
see  :  ['sees']
specie  :  ['species']
pupil  :  ['pupils']
estate  :  ['estates']
newsstand  :  ['newsstands']
owner  :  ['owners']
quarter  :  ['quarters']
serf  :  ['serves']
suit  :  ['suits']
transaction  :  ['transactions']
wife  :  ['wives']
channel  :  ['channels']
ear  :  ['ears']
passenger  :  ['passengers']
publication  :  ['publications']
race  :  ['races']
role  :  ['roles']
surround  :  ['surrounds']
us  :  ['uses']
wind  :  ['winds']
opinion  :  ['opinions']
temperature  :  ['temperatures']
arrangement  :  ['arrangements']
dozen  :  ['dozens']
ranking  :  ['rankings']
reform  :  ['reforms']
angle  :  ['angles']
degree  :  ['degrees']
enterprise  :  ['enterprises']
ground  :  ['grounds']
machine  :  ['machines']
mar  :  ['mars']
merchant  :  ['merchants']
organ  :  ['organs']
perspective  :  ['perspectives']
publisher  :  ['publishers']
seek  :  ['seeks']
sample  :  ['samples']
cent  :  ['cents']
discussion  :  ['discussions']
exchange  :  ['exchanges']
member  :  ['members']
molecule  :  ['molecules']
playoff  :  ['playoffs']
practice  :  ['practices']
resident  :  ['residents']
root  :  ['roots']
shareholder  :  ['shareholders']
tongue  :  ['tongues']
phase  :  ['phases']
structure  :  ['structures']
equation  :  ['equations']
civilian  :  ['civilians']
employee  :  ['employees']
follower  :  ['followers']
height  :  ['heights']
portion  :  ['portions']
president  :  ['presidents']
purpose  :  ['purposes']
ranger  :  ['rangers']
sheet  :  ['sheets']
speaker  :  ['speakers']
technique  :  ['techniques']
veteran  :  ['veterans']
wholesaler  :  ['wholesalers']
gene  :  ['genes']
intention  :  ['intentions']
lung  :  ['lungs']
rider  :  ['riders']
characteristic  :  ['characteristics']
dude  :  ['dudes']
instance  :  ['instances']
jew  :  ['jews']
leaf  :  ['leaves']
organism  :  ['organisms']
proportion  :  ['proportions']
sell  :  ['sells']
bee  :  ['bees']
column  :  ['columns']
cover  :  ['covers']
effort  :  ['efforts']
historian  :  ['historians']
layer  :  ['layers']
link  :  ['links']
mouth  :  ['mouths']
trustee  :  ['trustees']
utility  :  ['utilities']
sentence  :  ['sentences']
habit  :  ['habits']
appeal  :  ['appeals']
bear  :  ['bears']
come  :  ['comes']
decision  :  ['decisions']
finger  :  ['fingers']
hip  :  ['hips']
let  :  ['lets']
lord  :  ['lords']
mill  :  ['mills']
thigh  :  ['thighs']
trader  :  ['traders']
try  :  ['tries']
voter  :  ['voters']
department  :  ['departments']
aspect  :  ['aspects']
associate  :  ['associates']
client  :  ['clients']
consumer  :  ['consumers']
content  :  ['contents']
inning  :  ['innings']
match  :  ['matches']
organization  :  ['organizations']
roll  :  ['rolls']
title  :  ['titles']
ton  :  ['tons']
voice  :  ['voices']
analysis  :  ['analyses']
calculation  :  ['calculations']
warrior  :  ['warriors']
acquisition  :  ['acquisitions']
attempt  :  ['attempts']
criterion  :  ['criteria']
doctor  :  ['doctors']
holding  :  ['holdings']
material  :  ['materials']
note  :  ['notes']
property  :  ['properties']
rim  :  ['rims']
source  :  ['sources']
fella  :  ['fellas']
bottle  :  ['bottles']
box  :  ['boxes']
category  :  ['categories']
compound  :  ['compounds']
employer  :  ['employers']
exception  :  ['exceptions']
pea  :  ['peas']
plain  :  ['plains']
position  :  ['positions']
viking  :  ['vikings']
whisper  :  ['whispers']
fill  :  ['fills']
behavior  :  ['behaviors']
priest  :  ['priests']
atom  :  ['atoms']
crew  :  ['crews']
democrat  :  ['democrats']
effect  :  ['effects']
final  :  ['finals']
footstep  :  ['footsteps']
investor  :  ['investors']
retailer  :  ['retailers']
setting  :  ['settings']
sm  :  ['sms']
responsibility  :  ['responsibilities']
act  :  ['acts']
adviser  :  ['advisers']
element  :  ['elements']
method  :  ['methods']
particle  :  ['particles']
physic  :  ['physics']
session  :  ['sessions']
surface  :  ['surfaces']
user  :  ['users']
well  :  ['wells']
hall  :  ['halls']
brick  :  ['bricks']
carry  :  ['carries']
colony  :  ['colonies']
developer  :  ['developers']
expectation  :  ['expectations']
gut  :  ['guts']
instruction  :  ['instructions']
manufacturer  :  ['manufacturers']
pull  :  ['pulls']
stack  :  ['stacks']
statement  :  ['statements']
notion  :  ['notions']
situation  :  ['situations']
wrist  :  ['wrists']
drawer  :  ['drawers']
centre  :  ['centres']
curtain  :  ['curtains']
editor  :  ['editors']
import  :  ['imports']
pass  :  ['passes']
posse  :  ['possess']
tenant  :  ['tenants']
version  :  ['versions']
measurement  :  ['measurements']
reaction  :  ['reactions']
mode  :  ['modes']
floor  :  ['floors']
poll  :  ['polls']
rank  :  ['ranks']
reference  :  ['references']
signal  :  ['signals']
subject  :  ['subjects']
table  :  ['tables']
tweet  :  ['tweets']
inhabitant  :  ['inhabitants']
knock  :  ['knocks']
variable  :  ['variables']
definition  :  ['definitions']
hold  :  ['holds']
minister  :  ['ministers']
process  :  ['processes']
origin  :  ['origins']
spin  :  ['spins']
arm  :  ['arms']
file  :  ['files']
gram  :  ['grams']
soldier  :  ['soldiers']
standard  :  ['standards']
want  :  ['wants']
yard  :  ['yards']
illusion  :  ['illusions']
cap  :  ['caps']
clip  :  ['clips']
contract  :  ['contracts']
stock  :  ['stocks']
truck  :  ['trucks']
wake  :  ['wakes']
adam  :  ['adams']
colt  :  ['colts']
giant  :  ['giants']
current  :  ['currents']
editorial  :  ['editorials']
estimate  :  ['estimates']
ma  :  ['mas']
name  :  ['names']
negotiation  :  ['negotiations']
peep  :  ['peeps']
rebound  :  ['rebounds']
tell  :  ['tells']
tribe  :  ['tribes']
type  :  ['types']
circuit  :  ['circuits']
count  :  ['counts']
level  :  ['levels']
pound  :  ['pounds']
robert  :  ['roberts']
scale  :  ['scales']
tactic  :  ['tactics']
copy  :  ['copies']
inch  :  ['inches']
jacob  :  ['jacobs']
os  :  ['ora']
representative  :  ['representatives']
say  :  ['says']
stand  :  ['stands']
union  :  ['unions']
company  :  ['companies']
dia  :  ['dias']
direction  :  ['directions']
go  :  ['goes']
guideline  :  ['guidelines']
paper  :  ['papers']
unit  :  ['units']
motif  :  ['motives']
diplomat  :  ['diplomats']
driver  :  ['drivers']
elli  :  ['ellis']
matter  :  ['matters']
sort  :  ['sorts']
substance  :  ['substances']
tie  :  ['ties']
vessel  :  ['vessels']
depth  :  ['depths']
a  :  ['as']
brief  :  ['briefs']
county  :  ['counties']
doe  :  ['does']
immigrant  :  ['immigrants']
motor  :  ['motors']
net  :  ['nets']
system  :  ['systems']
tissue  :  ['tissues']
vein  :  ['veins']
yankee  :  ['yankees']
mass  :  ['masses']
norm  :  ['norms']
repeat  :  ['repeats']
bond  :  ['bonds']
journalist  :  ['journalists']
load  :  ['loads']
object  :  ['objects']
physician  :  ['physicians']
russian  :  ['russians']
section  :  ['sections']
tire  :  ['tires']
task  :  ['tasks']
board  :  ['boards']
bone  :  ['bones']
candidate  :  ['candidates']
ha  :  ['has']
knee  :  ['knees']
reporter  :  ['reporters']
serum  :  ['sera']
do  :  ['dos']
d  :  ['ds']
one  :  ['ones']
troop  :  ['troops']
ion  :  ['ions']
factor  :  ['factors']
firm  :  ['firms']
israeli  :  ['israelis']
subsidy  :  ['subsidies']
toe  :  ['toes']
territory  :  ['territories']
cop  :  ['cops']
pa  :  ['pas']
policy  :  ['policies']
shadow  :  ['shadows']
stair  :  ['stairs']
edge  :  ['edges']
population  :  ['populations']
base  :  ['bases']
cell  :  ['cells']
manager  :  ['managers']
mark  :  ['marks']
request  :  ['requests']
commissioner  :  ['commissioners']
law  :  ['laws']
na  :  ['nas']
scheme  :  ['schemes']
second  :  ['seconds']
specimen  :  ['specimens']
toda  :  ['todas']
au  :  ['aus']
committee  :  ['committees']
la  :  ['las']
sock  :  ['socks']
sympathy  :  ['sympathies']
hr  :  ['hrs']
measure  :  ['measures']
ovum  :  ['ova']
p  :  ['ps']
r  :  ['rss', 'rs']
statistic  :  ['statistics']
f  :  ['ves']
corner  :  ['corners']
string  :  ['strings']
tube  :  ['tubes']
analyst  :  ['analysts']
control  :  ['controls']
document  :  ['documents']
o  :  ['os']
parameter  :  ['parameters']
procedure  :  ['procedures']
ass  :  ['assess']
command  :  ['commands']
da  :  ['das']
executive  :  ['executives']
office  :  ['offices']
report  :  ['reports']
tweeter  :  ['tweeters']
edward  :  ['edwards']
hoe  :  ['hoes']
nail  :  ['nails']
need  :  ['needs']
officer  :  ['officers']
rapper  :  ['rappers']
throw  :  ['throws']
account  :  ['accounts']
drop  :  ['drops']
investigator  :  ['investigators']
it  :  ['its']
wi  :  ['wis']
temp  :  ['temps']
h  :  ['hs']
min  :  ['mins']
te  :  ['tes']
ante  :  ['antes']
agency  :  ['agencies']
army  :  ['armies']
bishop  :  ['bishops']
economist  :  ['economists']
me  :  ['mes']
bi  :  ['bis']
campaign  :  ['campaigns']
stick  :  ['sticks']
broad  :  ['broads']
cause  :  ['causes']
das  :  ['dass']
judge  :  ['judges']
lecture  :  ['lectures']
mi  :  ['mis']
regulator  :  ['regulators']
remark  :  ['remarks']
circumstance  :  ['circumstances']
division  :  ['divisions']
dat  :  ['dats']
decade  :  ['decades']
sander  :  ['sanders']
horn  :  ['horns']
addendum  :  ['addenda']
he  :  ['hes']
assumption  :  ['assumptions']
va  :  ['vas']
banker  :  ['bankers']
ed  :  ['eds']
e  :  ['es']
john  :  ['johns']
proceeding  :  ['proceedings']
who  :  ['whos']
yr  :  ['yrs']
condition  :  ['conditions']
de  :  ['des']
med  :  ['meds']
no  :  ['nos']
stake  :  ['stakes']
witness  :  ['witnesses']
governor  :  ['governors']
le  :  ['les', 'less']
official  :  ['officials']
piece  :  ['pieces']
target  :  ['targets']
wei  :  ['weiss']
dealer  :  ['dealers']
re  :  ['res']
trial  :  ['trials']
claim  :  ['claims']
s  :  ['ses']
obligation  :  ['obligations']
boundary  :  ['boundaries']
affair  :  ['affairs']
corp  :  ['corps']
co  :  ['cos']
lawmaker  :  ['lawmakers']
shake  :  ['shakes']
un  :  ['uns']
body  :  ['bodies']
institution  :  ['institutions']
knife  :  ['knives']
form  :  ['forms']
there  :  ['theres']
rap  :  ['raps']
wolf  :  ['wolves']
lb  :  ['lbs']
fragment  :  ['fragments']
stare  :  ['stares']
government  :  ['governments']
hole  :  ['holes']
peasant  :  ['peasants']
pig  :  ['pigs']
serb  :  ['serbs']
fed  :  ['feds']
difference  :  ['differences']
flame  :  ['flames']
v  :  ['vs']
wa  :  ['was']
al  :  ['als']
juror  :  ['jurors']
ad  :  ['ads']
block  :  ['blocks']
senator  :  ['senators']
chain  :  ['chains']
investigation  :  ['investigations']
mus  :  ['muss']
age  :  ['ages']
corporation  :  ['corporations']
palestinian  :  ['palestinians']
b  :  ['bs']
election  :  ['elections']
m  :  ['ms']
negro  :  ['negroes']
ash  :  ['ashes']
nerve  :  ['nerves']
crowd  :  ['crowds']
gat  :  ['gats']
kick  :  ['kicks']
errand  :  ['errands']
commercial  :  ['commercials']
constraint  :  ['constraints']
hide  :  ['hides']
regulation  :  ['regulations']
broker  :  ['brokers']
cu  :  ['cus']
hearing  :  ['hearings']
authority  :  ['authorities']
chill  :  ['chills']
competitor  :  ['competitors']
slip  :  ['slips']
acid  :  ['acids']
billing  :  ['billings']
operation  :  ['operations']
guard  :  ['guards']
muslim  :  ['muslims']
aid  :  ['aids']
guerrilla  :  ['guerrillas']
blow  :  ['blows']
defendant  :  ['defendants']
lawyer  :  ['lawyers']
court  :  ['courts']
protest  :  ['protests']
rebel  :  ['rebels']
due  :  ['dues']
freak  :  ['freaks']
calorie  :  ['calories']
republican  :  ['republicans']
legislator  :  ['legislators']
period  :  ['periods']
prosecutor  :  ['prosecutors']
whip  :  ['whips']
bos  :  ['boss']
force  :  ['forces']
smell  :  ['smells']
implication  :  ['implications']
blade  :  ['blades']
stranger  :  ['strangers']
pirate  :  ['pirates']
reduction  :  ['reductions']
taxpayer  :  ['taxpayers']
pill  :  ['pills']
rumor  :  ['rumors']
conservative  :  ['conservatives']
concern  :  ['concerns']
needle  :  ['needles']
chemical  :  ['chemicals']
consequence  :  ['consequences']
goodbye  :  ['goodbyes']
strike  :  ['strikes']
crack  :  ['cracks']
limit  :  ['limits']
zombie  :  ['zombies']
demand  :  ['demands']
punk  :  ['punks']
fist  :  ['fists']
slug  :  ['slugs']
charge  :  ['charges']
issue  :  ['issues']
rag  :  ['rags']
fiend  :  ['fiends']
as  :  ['ass']
sanction  :  ['sanctions']
allegation  :  ['allegations']
excuse  :  ['excuses']
ghost  :  ['ghosts']
loan  :  ['loans']
so  :  ['sos']
fade  :  ['fades']
critic  :  ['critics']
protester  :  ['protesters']
thorn  :  ['thorns']
battle  :  ['battles']
bug  :  ['bugs']
exam  :  ['exams']
risk  :  ['risks']
nothing  :  ['nothings']
symptom  :  ['symptoms']
hang  :  ['hangs']
patient  :  ['patients']
complication  :  ['complications']
snake  :  ['snakes']
lesion  :  ['lesions']
cut  :  ['cuts']
limitation  :  ['limitations']
suspect  :  ['suspects']
siren  :  ['sirens']
servant  :  ['servants']
stain  :  ['stains']
hospital  :  ['hospitals']
teardrop  :  ['teardrops']
pressure  :  ['pressures']
inmate  :  ['inmates']
opponent  :  ['opponents']
scream  :  ['screams']
monster  :  ['monsters']
dis  :  ['diss']
foe  :  ['foes']
trouble  :  ['troubles']
condolence  :  ['condolences']
whore  :  ['whores']
politician  :  ['politicians']
expense  :  ['expenses']
restriction  :  ['restrictions']
scar  :  ['scars']
cigarette  :  ['cigarettes']
doubt  :  ['doubts']
sucker  :  ['suckers']
rat  :  ['rats']
fool  :  ['fools']
pimp  :  ['pimps']
gangsta  :  ['gangstas']
loser  :  ['losers']
sinner  :  ['sinners']
accusation  :  ['accusations']
disorder  :  ['disorders']
suck  :  ['sucks']
defect  :  ['defects']
difficulty  :  ['difficulties']
graf  :  ['graves']
regret  :  ['regrets']
bullet  :  ['bullets']
idiot  :  ['idiots']
refugee  :  ['refugees']
argument  :  ['arguments']
complaint  :  ['complaints']
lawsuit  :  ['lawsuits']
fight  :  ['fights']
gun  :  ['guns']
conflict  :  ['conflicts']
damage  :  ['damages']
nigga  :  ['niggas']
cry  :  ['cries', 'crying']
problem  :  ['problems']
threat  :  ['threats']
sin  :  ['sins']
bomb  :  ['bombs']
error  :  ['errors']
violation  :  ['violations']
devil  :  ['devils']
bill  :  ['bills']
missile  :  ['missiles']
mourner  :  ['mourners']
wound  :  ['wounds']
burn  :  ['burns']
coward  :  ['cowards']
bitch  :  ['bitches']
arrest  :  ['arrests']
tax  :  ['taxes']
sorrow  :  ['sorrows']
bastard  :  ['bastards']
injury  :  ['injuries']
drug  :  ['drugs']
penalty  :  ['penalties']
tension  :  ['tensions']
demon  :  ['demons']
heartache  :  ['heartaches']
lie  :  ['lies']
thug  :  ['thugs']
worry  :  ['worries']
infection  :  ['infections']
nightmare  :  ['nightmares']
motherfucker  :  ['motherfuckers']
hater  :  ['haters']
loss  :  ['losses']
tear  :  ['tears']
enemy  :  ['enemies']
prisoner  :  ['prisoners']
weapon  :  ['weapons']
victim  :  ['victims']
thief  :  ['thieves']
crime  :  ['crimes']
hurt  :  ['hurts']
dy  :  ['dies']
slave  :  ['slaves']
killer  :  ['killers']
tumor  :  ['tumors']
disease  :  ['diseases']
killing  :  ['killings']
kill  :  ['kills']